"filename", "language", "C++", "CMake", "comment", "blank", "total"
"/home/xie/code/QuestCAE/questCAE/CMakeLists.txt", "CMake", 0, 3, 0, 1, 4
"/home/xie/code/QuestCAE/questCAE/IO/logger.cpp", "C++", 64, 0, 5, 24, 93
"/home/xie/code/QuestCAE/questCAE/IO/logger.hpp", "C++", 122, 0, 6, 43, 171
"/home/xie/code/QuestCAE/questCAE/IO/logger_message.cpp", "C++", 53, 0, 3, 17, 73
"/home/xie/code/QuestCAE/questCAE/IO/logger_message.hpp", "C++", 168, 0, 5, 64, 237
"/home/xie/code/QuestCAE/questCAE/IO/logger_output.cpp", "C++", 99, 0, 5, 27, 131
"/home/xie/code/QuestCAE/questCAE/IO/logger_output.hpp", "C++", 93, 0, 5, 37, 135
"/home/xie/code/QuestCAE/questCAE/container/array_1d.hpp", "C++", 411, 0, 12, 84, 507
"/home/xie/code/QuestCAE/questCAE/container/data_value_container.cpp", "C++", 58, 0, 4, 14, 76
"/home/xie/code/QuestCAE/questCAE/container/data_value_container.hpp", "C++", 172, 0, 5, 82, 259
"/home/xie/code/QuestCAE/questCAE/container/flags.cpp", "C++", 59, 0, 3, 18, 80
"/home/xie/code/QuestCAE/questCAE/container/flags.hpp", "C++", 175, 0, 6, 62, 243
"/home/xie/code/QuestCAE/questCAE/container/global_pointers_vector.hpp", "C++", 7, 0, 5, 5, 17
"/home/xie/code/QuestCAE/questCAE/container/nodal_data.cpp", "C++", 35, 0, 4, 14, 53
"/home/xie/code/QuestCAE/questCAE/container/nodal_data.hpp", "C++", 58, 0, 5, 33, 96
"/home/xie/code/QuestCAE/questCAE/container/variable.hpp", "C++", 167, 0, 5, 50, 222
"/home/xie/code/QuestCAE/questCAE/container/variable_data.cpp", "C++", 67, 0, 4, 26, 97
"/home/xie/code/QuestCAE/questCAE/container/variable_data.hpp", "C++", 97, 0, 21, 53, 171
"/home/xie/code/QuestCAE/questCAE/container/variables_list.cpp", "C++", 44, 0, 4, 6, 54
"/home/xie/code/QuestCAE/questCAE/container/variables_list.hpp", "C++", 326, 0, 6, 104, 436
"/home/xie/code/QuestCAE/questCAE/container/variables_list_data_value_container.hpp", "C++", 561, 0, 5, 142, 708
"/home/xie/code/QuestCAE/questCAE/container/weak_pointer_vector.hpp", "C++", 202, 0, 6, 67, 275
"/home/xie/code/QuestCAE/questCAE/container/weak_pointer_vector_iterator.hpp", "C++", 24, 0, 6, 15, 45
"/home/xie/code/QuestCAE/questCAE/includes/check.hpp", "C++", 185, 0, 6, 47, 238
"/home/xie/code/QuestCAE/questCAE/includes/code_location.hpp", "C++", 54, 0, 6, 31, 91
"/home/xie/code/QuestCAE/questCAE/includes/data_communicator.hpp", "C++", 496, 0, 53, 117, 666
"/home/xie/code/QuestCAE/questCAE/includes/define.hpp", "C++", 69, 0, 14, 23, 106
"/home/xie/code/QuestCAE/questCAE/includes/dof.hpp", "C++", 286, 0, 6, 76, 368
"/home/xie/code/QuestCAE/questCAE/includes/exceptions.hpp", "C++", 61, 0, 7, 36, 104
"/home/xie/code/QuestCAE/questCAE/includes/fill_communicator.hpp", "C++", 49, 0, 4, 28, 81
"/home/xie/code/QuestCAE/questCAE/includes/fnv_1a_hash.hpp", "C++", 44, 0, 5, 24, 73
"/home/xie/code/QuestCAE/questCAE/includes/global_pointer.hpp", "C++", 9, 0, 5, 7, 21
"/home/xie/code/QuestCAE/questCAE/includes/global_variables.hpp", "C++", 19, 0, 3, 6, 28
"/home/xie/code/QuestCAE/questCAE/includes/key_hash.hpp", "C++", 158, 0, 33, 37, 228
"/home/xie/code/QuestCAE/questCAE/includes/lock_object.hpp", "C++", 54, 0, 6, 15, 75
"/home/xie/code/QuestCAE/questCAE/includes/model_part.hpp", "C++", 0, 0, 0, 1, 1
"/home/xie/code/QuestCAE/questCAE/includes/mpi_serializer.hpp", "C++", 27, 0, 5, 12, 44
"/home/xie/code/QuestCAE/questCAE/includes/parallel_enviroment.hpp", "C++", 88, 0, 7, 69, 164
"/home/xie/code/QuestCAE/questCAE/includes/process_info.hpp", "C++", 135, 0, 5, 90, 230
"/home/xie/code/QuestCAE/questCAE/includes/quest_components.hpp", "C++", 168, 0, 5, 53, 226
"/home/xie/code/QuestCAE/questCAE/includes/quest_export_api.hpp", "C++", 32, 0, 3, 8, 43
"/home/xie/code/QuestCAE/questCAE/includes/quest_filesystem.hpp", "C++", 20, 0, 9, 17, 46
"/home/xie/code/QuestCAE/questCAE/includes/quest_parameters.hpp", "C++", 197, 0, 18, 154, 369
"/home/xie/code/QuestCAE/questCAE/includes/quset.hpp", "C++", 6, 0, 6, 10, 22
"/home/xie/code/QuestCAE/questCAE/includes/registry.hpp", "C++", 91, 0, 5, 42, 138
"/home/xie/code/QuestCAE/questCAE/includes/registry_item.hpp", "C++", 157, 0, 6, 73, 236
"/home/xie/code/QuestCAE/questCAE/includes/serializer.hpp", "C++", 767, 0, 6, 216, 989
"/home/xie/code/QuestCAE/questCAE/includes/smart_pointers.hpp", "C++", 54, 0, 5, 19, 78
"/home/xie/code/QuestCAE/questCAE/includes/stream_serializer.hpp", "C++", 29, 0, 5, 18, 52
"/home/xie/code/QuestCAE/questCAE/includes/ublas_complex_interface.hpp", "C++", 51, 0, 6, 12, 69
"/home/xie/code/QuestCAE/questCAE/includes/ublas_interface.hpp", "C++", 54, 0, 6, 16, 76
"/home/xie/code/QuestCAE/questCAE/includes/variables.hpp", "C++", 10, 0, 5, 6, 21
"/home/xie/code/QuestCAE/questCAE/sources/code_location.cpp", "C++", 103, 0, 4, 18, 125
"/home/xie/code/QuestCAE/questCAE/sources/exceptions.cpp", "C++", 70, 0, 5, 24, 99
"/home/xie/code/QuestCAE/questCAE/sources/fill_communicator.cpp", "C++", 39, 0, 4, 19, 62
"/home/xie/code/QuestCAE/questCAE/sources/key_hash.cpp", "C++", 16, 0, 4, 9, 29
"/home/xie/code/QuestCAE/questCAE/sources/process_info.cpp", "C++", 0, 0, 0, 1, 1
"/home/xie/code/QuestCAE/questCAE/sources/queat_parameters.cpp", "C++", 833, 0, 6, 301, 1140
"/home/xie/code/QuestCAE/questCAE/sources/quest_components.cpp", "C++", 0, 0, 4, 2, 6
"/home/xie/code/QuestCAE/questCAE/sources/quest_filesystem.cpp", "C++", 35, 0, 5, 11, 51
"/home/xie/code/QuestCAE/questCAE/sources/registry.cpp", "C++", 86, 0, 5, 33, 124
"/home/xie/code/QuestCAE/questCAE/sources/registry_item.cpp", "C++", 111, 0, 4, 30, 145
"/home/xie/code/QuestCAE/questCAE/utilities/color_utilities.hpp", "C++", 48, 0, 3, 7, 58
"/home/xie/code/QuestCAE/questCAE/utilities/counter.hpp", "C++", 47, 0, 6, 22, 75
"/home/xie/code/QuestCAE/questCAE/utilities/openmp_utils.hpp", "C++", 75, 0, 6, 18, 99
"/home/xie/code/QuestCAE/questCAE/utilities/parallel_utilities.cpp", "C++", 89, 0, 5, 28, 122
"/home/xie/code/QuestCAE/questCAE/utilities/parallel_utilities.hpp", "C++", 308, 0, 15, 80, 403
"/home/xie/code/QuestCAE/questCAE/utilities/quaternion.hpp", "C++", 293, 0, 16, 74, 383
"/home/xie/code/QuestCAE/questCAE/utilities/stl_vector_io.hpp", "C++", 17, 0, 5, 10, 32
"/home/xie/code/QuestCAE/questCAE/utilities/string_utilities.cpp", "C++", 107, 0, 5, 41, 153
"/home/xie/code/QuestCAE/questCAE/utilities/string_utilities.hpp", "C++", 31, 0, 16, 20, 67
"Total", "-", 8740, 3, 498, 2999, 12240