"filename", "language", "C++", "Markdown", "comment", "blank", "total"
"/home/xie/code/QuestCAE/README.md", "Markdown", 0, 32, 0, 34, 66
"/home/xie/code/QuestCAE/exLibraries/boost/ublas_complex_interface.hpp", "C++", 51, 0, 6, 12, 69
"/home/xie/code/QuestCAE/exLibraries/boost/ublas_interface.hpp", "C++", 54, 0, 6, 16, 76
"/home/xie/code/QuestCAE/exLibraries/intrusive_ptr/intrusive_ptr.hpp", "C++", 182, 0, 4, 52, 238
"/home/xie/code/QuestCAE/questCAE/IO/logger.hpp", "C++", 0, 0, 0, 1, 1
"/home/xie/code/QuestCAE/questCAE/IO/logger_message.cpp", "C++", 53, 0, 3, 17, 73
"/home/xie/code/QuestCAE/questCAE/IO/logger_message.hpp", "C++", 168, 0, 5, 64, 237
"/home/xie/code/QuestCAE/questCAE/IO/logger_output.cpp", "C++", 0, 0, 0, 1, 1
"/home/xie/code/QuestCAE/questCAE/IO/logger_output.hpp", "C++", 11, 0, 5, 9, 25
"/home/xie/code/QuestCAE/questCAE/container/array_1d.hpp", "C++", 411, 0, 12, 84, 507
"/home/xie/code/QuestCAE/questCAE/container/flags.cpp", "C++", 59, 0, 3, 18, 80
"/home/xie/code/QuestCAE/questCAE/container/flags.hpp", "C++", 175, 0, 6, 62, 243
"/home/xie/code/QuestCAE/questCAE/includes/check.hpp", "C++", 185, 0, 6, 47, 238
"/home/xie/code/QuestCAE/questCAE/includes/code_location.hpp", "C++", 54, 0, 6, 31, 91
"/home/xie/code/QuestCAE/questCAE/includes/define.hpp", "C++", 13, 0, 5, 10, 28
"/home/xie/code/QuestCAE/questCAE/includes/exceptions.hpp", "C++", 61, 0, 7, 36, 104
"/home/xie/code/QuestCAE/questCAE/includes/quest_export_api.hpp", "C++", 32, 0, 3, 8, 43
"/home/xie/code/QuestCAE/questCAE/includes/quset.hpp", "C++", 6, 0, 6, 10, 22
"/home/xie/code/QuestCAE/questCAE/includes/serializer.hpp", "C++", 0, 0, 0, 1, 1
"/home/xie/code/QuestCAE/questCAE/includes/smart_pointers.hpp", "C++", 54, 0, 5, 19, 78
"/home/xie/code/QuestCAE/questCAE/sources/code_location.cpp", "C++", 103, 0, 4, 18, 125
"/home/xie/code/QuestCAE/questCAE/sources/exceptions.cpp", "C++", 70, 0, 5, 24, 99
"/home/xie/code/QuestCAE/questCAE/utilities/stl_vector_io.hpp", "C++", 17, 0, 5, 10, 32
"Total", "-", 1759, 32, 102, 584, 2477