"filename", "language", "C++", "comment", "blank", "total"
"/home/xie/code/QuestCAE/exLibraries/boost/ublas_complex_interface.hpp", "C++", 51, 6, 12, 69
"/home/xie/code/QuestCAE/exLibraries/boost/ublas_interface.hpp", "C++", 54, 6, 16, 76
"/home/xie/code/QuestCAE/exLibraries/intrusive_ptr/intrusive_ptr.hpp", "C++", 182, 4, 52, 238
"/home/xie/code/QuestCAE/external_libraries/boost/instrusive_ptr.hpp", "C++", 0, 0, -1, -1
"/home/xie/code/QuestCAE/external_libraries/boost/ublas_complex_interface.hpp", "C++", -25, -6, -10, -41
"/home/xie/code/QuestCAE/external_libraries/boost/ublas_interface.hpp", "C++", -54, -6, -16, -76
"/home/xie/code/QuestCAE/questCAE/container/array_1d.hpp", "C++", 19, 6, 10, 35
"/home/xie/code/QuestCAE/questCAE/includes/define.hpp", "C++", 5, 2, 2, 9
"/home/xie/code/QuestCAE/questCAE/includes/smart_pointers.hpp", "C++", 54, 5, 19, 78
"Total", "-", 286, 17, 84, 387