"filename", "language", "C++", "Markdown", "comment", "blank", "total"
"/home/xie/code/QuestCAE/README.md", "Markdown", 0, 32, 0, 34, 66
"/home/xie/code/QuestCAE/external_libraries/boost/instrusive_ptr.hpp", "C++", 0, 0, 0, 1, 1
"/home/xie/code/QuestCAE/external_libraries/boost/ublas_complex_interface.hpp", "C++", 25, 0, 6, 10, 41
"/home/xie/code/QuestCAE/external_libraries/boost/ublas_interface.hpp", "C++", 54, 0, 6, 16, 76
"/home/xie/code/QuestCAE/questCAE/IO/io.hpp", "C++", 0, 0, 0, 1, 1
"/home/xie/code/QuestCAE/questCAE/includes/check.hpp", "C++", 185, 0, 6, 47, 238
"/home/xie/code/QuestCAE/questCAE/includes/code_location.hpp", "C++", 54, 0, 6, 31, 91
"/home/xie/code/QuestCAE/questCAE/includes/define.hpp", "C++", 3, 0, 3, 6, 12
"/home/xie/code/QuestCAE/questCAE/includes/exceptions.hpp", "C++", 61, 0, 7, 36, 104
"/home/xie/code/QuestCAE/questCAE/includes/quest_export_api.hpp", "C++", 32, 0, 3, 8, 43
"/home/xie/code/QuestCAE/questCAE/includes/quset.hpp", "C++", 6, 0, 6, 10, 22
"/home/xie/code/QuestCAE/questCAE/matrix/bcsr_matrix.hpp", "C++", 0, 0, 0, 1, 1
"/home/xie/code/QuestCAE/questCAE/model/model.hpp", "C++", 0, 0, 0, 1, 1
"/home/xie/code/QuestCAE/questCAE/sources/code_location.cpp", "C++", 104, 0, 4, 18, 126
"/home/xie/code/QuestCAE/questCAE/sources/exceptions.cpp", "C++", 71, 0, 5, 24, 100
"/home/xie/code/QuestCAE/questCAE/utilities/stl_vector_io.hpp", "C++", 17, 0, 5, 10, 32
"Total", "-", 612, 32, 57, 254, 955