"filename", "language", "C++", "Markdown", "comment", "blank", "total"
"/home/xie/code/QuestCAE/README.md", "Markdown", 0, -32, 0, -34, -66
"/home/xie/code/QuestCAE/exLibraries/boost/ublas_complex_interface.hpp", "C++", -51, 0, -6, -12, -69
"/home/xie/code/QuestCAE/exLibraries/boost/ublas_interface.hpp", "C++", -54, 0, -6, -16, -76
"/home/xie/code/QuestCAE/exLibraries/intrusive_ptr/intrusive_ptr.hpp", "C++", -182, 0, -4, -52, -238
"/home/xie/code/QuestCAE/questCAE/IO/io.hpp", "C++", 0, 0, 0, -1, -1
"/home/xie/code/QuestCAE/questCAE/IO/logger_message.cpp", "C++", 0, 0, 0, 1, 1
"/home/xie/code/QuestCAE/questCAE/IO/logger_message.hpp", "C++", 168, 0, 5, 64, 237
"/home/xie/code/QuestCAE/questCAE/matrix/bcsr_matrix.hpp", "C++", 0, 0, 0, -1, -1
"/home/xie/code/QuestCAE/questCAE/model/model.hpp", "C++", 0, 0, 0, -1, -1
"Total", "-", -119, -32, -11, -52, -214