"filename", "language", "C++", "comment", "blank", "total"
"/home/xie/code/QuestCAE/questCAE/IO/logger_message.cpp", "C++", 0, 0, 1, 1
"/home/xie/code/QuestCAE/questCAE/IO/logger_message.hpp", "C++", 168, 5, 64, 237
"/home/xie/code/QuestCAE/questCAE/container/array_1d.hpp", "C++", 411, 12, 84, 507
"/home/xie/code/QuestCAE/questCAE/includes/check.hpp", "C++", 185, 6, 47, 238
"/home/xie/code/QuestCAE/questCAE/includes/code_location.hpp", "C++", 54, 6, 31, 91
"/home/xie/code/QuestCAE/questCAE/includes/define.hpp", "C++", 8, 5, 8, 21
"/home/xie/code/QuestCAE/questCAE/includes/exceptions.hpp", "C++", 61, 7, 36, 104
"/home/xie/code/QuestCAE/questCAE/includes/quest_export_api.hpp", "C++", 32, 3, 8, 43
"/home/xie/code/QuestCAE/questCAE/includes/quset.hpp", "C++", 6, 6, 10, 22
"/home/xie/code/QuestCAE/questCAE/includes/smart_pointers.hpp", "C++", 54, 5, 19, 78
"/home/xie/code/QuestCAE/questCAE/sources/code_location.cpp", "C++", 104, 4, 18, 126
"/home/xie/code/QuestCAE/questCAE/sources/exceptions.cpp", "C++", 71, 5, 24, 100
"/home/xie/code/QuestCAE/questCAE/utilities/stl_vector_io.hpp", "C++", 17, 5, 10, 32
"Total", "-", 1171, 69, 360, 1600